Ahmet Furkan	Yardımcı
Ahmet Mehdi	Şerifoğlu
Ahmet Polat	Seyfi
Alper	Orhan
Ayşe Aylin	Şevkin
Bahar Özlem	Yardımcı
Bedia	Fındık
Bedriye Seray	Esgin
Behin	Esgin
Buket	Şerifoğlu
Caner Hazar	Deliloğlu
Cankız	Esgin
Cem Ozan	Dinçtürk
Ceyhun Kadir	Tezmen
Demircan	Ciddi
Dilay Nur	Esgin
Doktora	Oçar
Doğuşcan	Orhan
Ecem Hatice	Zağlı
Edis	Tezmen
Efecan	Tezmen
Eser	Şevkin
Esim	Zaptiye
Fahir	Sevcan
Feray	Yardımcı
Ferdacan	Cansu
Fethullah	Fındık
Gül Sena	Yardımcı
Gülender	Şerifoğlu
Gülpınar	Zaptiye
Gülten	Şevkin
Günan	Ciddi
Halim	Fındık
Haluk Barış	Şerifoğlu
Hasan Burak	Tezmen
Hatice Büşra	Şevkin
Hulki	Şerifoğlu
Ilgaz	Yardımcı
Işıltı	Orhan
Işınbıke	Tanrıkulu
Jiyan	Tezmen
Kemal Tolga	Fındık
Kerime Hacer	Zağlı
Kubat	Fındık
Kubilay	Tanrıkulu
Köker	Yardımcı
Latife	Şevkin
Lawrence Tezoh	Egin
Lerzan	Ciddi
Lütfiye Sena	Dinçtürk
Mehmet Gökalp	Dinçtürk
Mihrinaz	Cansu
Muhammed Üzeyir	Tanrıkulu
Mustafa Taha	Fatin
Nugaye	Fındık
Numan	Orhan
Nurfer	Sevcan
Nüket	Şerifoğlu
Nüvit	Deliloğlu
Okbay	Şevkin
Oktay Emir	Zaptiye
Osman Emre	Esgin
Oğuzcan	Fındık
Paker	Ciddi
Paksoy	Zaptiye
Perker	Oçar
Pertev	Seyfi
Raif	Tezmen
Ramazan Tarık	Dinçtürk
Rana	Yolcu
Rima	Yardımcı
Sabiha Esra	Tezmen
Samet Emre	Şerifoğlu
Selcen	Şevkin
Sena Nur	Deliloğlu
Seung Hun	Tezmen
Talya	Dinçtürk
Taylan Remzi	Egin
Tayyip	Şevkin
Tunahan	Deliloğlu
Ugur Can	Zaptiye
Uluç Emre	Yardımcı
Uzel	Deliloğlu
Vahide	Şerifoğlu
Vedia	Yolcu
Velit	Fatin
Yaprak	Zağlı
Yasemin	Deliloğlu
Yasemin Erva	Tezmen
Yaşar Fatih Enes	Esgin
Yeliz	Zağlı
Zeynep Ecehan	Zaptiye
Zeynep Senahan	Ciddi
Zeynep Tuba	Ciddi
Zülcenah	Şerifoğlu
Çağatay	Sevcan
Çağla	Deliloğlu
Çağrı Atahan	Fatin
Çağın	Oçar
Çeliker	Dinçtürk
Ödül	Zağlı
Öktem	Tezmen
Ömer Faruk	Cansu
Ömer Okan	Ciddi
Önel	Egin
Ülker	Yolcu
Ümran	Yolcu
Ümıt	Tezmen
İlma	Fındık
İrem Başak	Cansu
İrfan Anıl	Şevkin
İslam	Egin
İsmail Enes	Sevcan
Şahan	Ciddi
Şemsi Yiğit	Şevkin
Şeniz	Sevcan
Şensoy	Oçar
Şerif Erkam	Ciddi
Melih	Egin
Tuğba	Zağlı